TTTTTTTTTTTTTTTT
T              T
T              T
T              T
T       L      T
T       TTTT TTT
T       T      T
TTP  LKKT   K  T
TTTTTTTTTTTTTTTT