TTTTTTTTTTTTTTTTTT  T
T                T  T
T                T  T
T                T  T
T                T  T
T                T  T
T                   T
T                   T
T                   T
T                TTTT
T            TT     T
T             T     T
T      TT           T
T P TKKTT  L     TTTT
TTTTTTTTTTTTTTTTTTTTT