000000000000000000000
000000000000000000000
000000000000000000000
000000000000000000000
000000000000000000000
00000TTTTKKTTTT000000
00000TEETTTTEET000000
000000000000000000000
00L00000000000000T000
TTT00000000000000TTTT
0000000000000TT000000
000000000000000000000
0000000TT00000000T000            
T0P0TKKTT00L00000TTTT
TTTTTTTTT  TTTTTTTTTT