1111111111111111
1000000000100001
1111110111111011
1010000000000001
1000000001000001
1100111111110111
1000000110000001
1100001110000001
1111111111111111