TTTTTTTTTTTTTTTTTTTTT
T                T  T
T                T  T
T  T  T T   T    T  T
T  T  T T   T    T  T
T  T  T T   T    T  T
T  T  T T   T       T
T  T  T T   T       T
T  T        T       T
T  T        T T  TTTT
T  T          T     T
T             TT    T
T      TT           T
T P TKKTT   L     TTT
TTTTTTTTTTTTTTTTTTTTT