TTTTTTTTTTTTTTTT
T              T
T              T
T              T
T       L      T
T       TTTT TTT
T       T      T
TTP  L  T   K  T
TTTTTTTTTTTTTTTT