TTTTTTTTTTTTTTTT
T              T
T              T
T              T
T              T
T              T
T       T      T
T P  TTKTL     T
TTTTTTTTTTTTTTTT