000000000000000000000
000000000000000000000
000000000GG0000000000
000000000000000000000
00000GGGG00GGGG000000
00000TTTTKKTTTT000000
00000TEETTTTEET000000
00000T00000000000T000
GGL00000000000000TGGG
TTT0000000000GG00TTTT
0000000000000TT000000
0000000GT00000000G000
G000G00TT00000000TGGG
TGPGTKKTT00LGGGGGTTTT
TTTTTTTTT  TTTTTTTTTT