000TTT0000000T0000000
0000000000000T0000000
0000E00000000T0000000
000000000000000000000
0000T00000000000E0000
0000T0000000000000000
TTTTTTTTTTTTTTTTTTTTT
000000000000000000000
000000000000000000000
000000000000000000000
000000000000000000000
000000000000000000000
T0P000000000T0000000T
TTTTT000T000T00GGG00T
TTTTTTTTTTTTTTTTTTTTT