000000000000000000000
000000000000000000000
000000000000000000000
000000000000000000000
000000000000000000000
000000000000000000000
000000000000000000000
000000000000000000000
000000000000000000000
G0E0GG000GPG000GG0E0G
T000TT000TTT000TT000T
T000TT000TTT000TT000T
T000TT000TTT000TT000T
TKKKTTKKKTTTKKKTTKKKT
TTTTTTTTTTTTTTTTTTTTT