000000000000000000000
000000000000000000000
000000000000000000000
000000000000000000000
0000000000G0000000000
000000000000000000000
000000000000000000000
000000000000000000000
000000000000000000000
000000000000000000000
000000000000000000000
000000000000000000000
000000000000000000000
0000000000P0000000000
TTTTTTTTTTTTTTTTTTTTT