000000000000000000000
000000000000000000000
00G000G0GGG0GGG0GGG00
00GG00G00G00G000G0000
00G0G0G00G00G000GGG00
00G00GG00G00G000G0000
00G000G0GGG0GGG0GGG00
000000000000000000000
000000000000000000000
000000000000000000000
000000000000000000000
000000000000000000000
000000000000000000000
0000000000P0000000000
TTTTTTTTTTTTTTTTTTTTT