000000000000000000000
000000000000000000000
000000000000000000000
000000000000000000000
000000000000000000000
000000000000000000000
000000000000000000000
000000000000000000000
000000000000000000000
000000000000000000000
000000000000000000000
000000000000000000000
G0EG0G0G0GPG0G0G0GE0G
TKKTKTKTKTTTKTKTKTKKT
TTTTTTTTTTTTTTTTTTTTT