TTTTTTTTTTTTTTTTTTTTT
TE00000000E00000000ET
T0000000000000000000T
T0000000000000000000T
T0G0G000G000G000G0G0T
TEG0TKKKTKKKTKKKT0GET
T0G0TTTTTTTTTTTTT0G0T
T0G000000000000ET0G0T
T0G0000000000000T0G0T
TEGGGGGGGGGGGGGET0G0T
TTTTTTTTTTTTTTTTT0G0T
T00000000000000000G0T
T00000000000000000G0T
T00P00GGGGGGGGGGGGGET
TTTTTTTTTTTTTTTTTTTTT