000000000000000000000
000000000000000000000
GGGG00000000000000GGG
TTTT000000000G000G0TT
TT0000000000G0G0G00TT
000E0000GGGG000G00000
0000000G0TTT000L00000
0000000G0000000T00000
0000000G0000000000000
0000000LGGGG0000E0000
0000000TTT00G00000000
00000000TT000G0000000
00000000TT000G0000000
KKKKKKKKTTKKKL00P00KK
TTTTTTTTTTTTTTTTTTTTT