000000000000000000000
000000000000000000000
000000000000000000000
000000000000000000000
000000000000000000000
000000000000000000000
000000000000000000000
000000000000000000000
000000000000000000000
00000000000GGG0000000
0000000GGG0TTT0000000
0000000TTT0TTT0000000
0000000TTTETTT0000000
000P000TTTKTTT00GGG00
TTTTTTTTTTTTTTTTTTTTT