000000000000000000000
0G000G0GGG0GGGG0GGGG0
0G00GG00G00G0000G0000
0G0G0G00G00G0000GGGG0
0GG00G00G00G0000G0000
0G000G0GGG0GGGG0GGGG0
000000000000000000000
000000000000000000000
000000000000000000000
000000000000000000000
000000000000000000000
000000000000000000000
000000000000000000000
000000000P00000000000
TTTTTTTTTTTTTTTTTTTTT