TTTTT00000000000TTTTT
TEE000000000000000EET
000000000000000000000
000000000000000000000
000000000000000000000
00000G00GGGGG00G00000
00000T00TTTTT00T00000
0000000000T0000000000
GGGL000000T000000LGGG
TTTT0000GGTGG0000TTTT
00000000TTTTT00000000
000000000000000000000
GGGG0000000000000GGGG
TTTTGGLGGGPGGGLGGTTTT
TTTTTTTTTTTTTTTTTTTTT