000000000000000000000
000000000000000000000
000000000000000000000
000000GGGGGG000000000
000000TTTTTT000000000
00GGGG000E0000000000E
00TTTTTT0000000000000
000E000000000E00GGGG0
TTTT00000000000TTTTTT
0000000000000TTTTT000
000000E000GG00TTT000E
000000000TTTTTTTTT000
00E000GG00TTTTTTT000E
00P00TTTTTTTTTTTTT000
TTTTTTTTTTTTTTTTTTTTT