000000000000000000000
000000000000000000000
000000000000000000000
000000000000000000000
000000000000000000000
000000000000000000000
000000000000000000000
000000000000000000000
000000000000000000000
000000000000000000000
000000000000000000000
000000000000000000000
G0E0GG000GPG000GG0E0G
TKKKTTKKKTTTKKKTTKKKT
TTTTTTTTTTTTTTTTTTTTT