000000000000000000000
000000000000000000000
000000000000000000000
000000000000000000000
000G000000G000000G000
00GTG0000GTG0000GTG00
00000000000000E000000
00GTG0000GTG0000GTG00
0000000000E0000000000
00GTG0000GTG0000GTG00
000000E00000000000000
00GTG0000GTG0000GTG00
000000000000000000000
0000000000P0000000000
TTTTTTTTTTTTTTTTTTTTT