000000000000000000000
000000000000000000000
000000000000000000000
000000000000000000000
000000000000000000000
000000000000000000000
000000000000000000000
000000000000000000000
000000000000000000000
000000000000000000000
0000000000E000000E000
GGG0GGGGGGEGGGGGGGGGG
GGGEGGGGGGGGGGGGGEGGG
GGGEGGGGGGPGGGGGGGGGG
TTTTTTTTTTTTTTTTTTTTT