000000000000000000000
00GGG00000000000GGG00
00TTT00000000000TTT00
000T0000000000000T000
00000000G000G00000000
00000000LGGGL00000000
00000000TTTTT00000000
00000G00T0E0T00G00000
GG000L0000E0000L000GG
TT0G0T000000000T0G0TT
000G0000000000000G000
000G0000000000000G000
000L000000P000000L000
0E0T0GGGG0T0GGGG0T0E0
TTTTTTTTTTTTTTTTTTTTT