000000000000000000000
000000000000000000000
000000000000000000000
000000000000000000000
000000000000000000000
000000000000000000000
000000000000000000000
000000000000000000000
000000000000000000000
000000000000000000000
000000000000000000000
0000000000E000GGGG0E0
000GGGG0000000TTTT000
KKKTTTT000P000TTTTKKK
TTTTTTTTTTTTTTTTTTTTT