0000000000P0000000000
000000000000000000000
000000000G0G000000000
000000000G0G000000000
00000G000G0G000G00000
00000G0000G0000G00000
0000G00000G00000G0000
0000G00000G00000G0000
000G00000G0G00000G000
000G00000G0G00000G000
0000G0000G0G0000G0000
0000G000G000G000G0000
0000G000G000G000G0000
0000G000G000G000G0000
0000G000G000G000G0000