TTTTTTTTTTTTTTTTTTTTT
T000000000TT00000000T
T0E0000000TT0E0000E0T
T000000000TT00000000T
T000GTT0G0TT0G0TT0G0T
T000GTT0G0TT0G0TT0G0T
T000GTT0G0TT0G0TT0G0T
T0000TT0G0TT0G0TT0G0T
T0000TT0G0TT0G0TT0G0T
T0GLLTT0G0TT0G0TT0G0T
T0GTTTT0G0TT0G0TT0G0T
T0G000000000000TT0G0T
T0000000E0000E0TT0G0T
TLL000000000000TT0P0T
TTTTTTTTTTTTTTTTTTTTT